###########################################
#.............................#...........#
#.G......S....................M...........###
#.............................#.............#
#.............########........####..........#
#.............#..G.#M.........#E.#..........#
#.............#...............#..#..........#
###...........##############..##.#..........#
  #.................G#     #..#G............#
  ####################     ##################










